##############################
##            ##            ##
## #### ##### ## ##### #### ##
##P#### ##### ## ##### ####P##
## #### ##### ## ##### #### ##
##                          ##
## #### ## ######## ## #### ##
## #### ## ######## ## #### ##
##      ##    ##    ##      ##
####### ##### ## ##### #######
####### ##### ## ##### #######
####### ##          ## #######
####### ## ###GG### ## #######
####### ## ##CCCC## ## #######
T          ##CCCC##          T
####### ## ######## ## #######
####### ## ######## ## #######
####### ##          ## #######
####### ## ######## ## #######
####### ## ######## ## #######
##            ##            ##
## #### ##### ## ##### #### ##
##P#### ##### ## ##### ####P##
##   ## .....          ##   ##
#### ## ## ######## ## ## ####
#### ## ## ######## ## ## ####
##      ##    ##    ##      ##
## ########## ## ########## ##
## ########## ## ########## ##
##                          ##
##############################
